%%%%%%%%%%%%
%..........%
%..........%
%..........%
%..........%
%.....P....%
%..........%
%..........%
%..........%
%..........%
%%%%%%%%%%%%